#map de test avec differentes tailles de lignes
# et mauvais caractères
1 1 1 1 1 1 1 1 1 1 1 1 1 1 1 1 1 1 1 1
1 0 0 0 0 0 0 0 0 0 0 0 0 0 0 0 0 0 0 1
1 0 0 0 0 0 0 0 0 0 0 0 0 0 0 0 0 0 0 1
1 0 0 0 0 0 0 0 1 0 1 0 1 0 0 0 0 0 0 
1 0 0 0 0 0 0 0 0 1 1 1 1 1 0 0 0 0 
1 0 0 0 0 0 0 0 1 1 0 0 1 0 0 0 0 0  
1 0 0 9 0 0 0 0 0 1 0 0 1 1 0 0 0 0 0 1
1 0  0 0 0 0 0 0 0 0 0 0 0 0 0 0 0 0 1
1 0 0 0 0 0 0 0 0 0 0 0 0 0 0 0 0 0 0 1
1 1 1 1 1 1 1 1 1 1 1 1 1 1 1 1 1 A B C